tileswide 40
tileshigh 39
tilewidth 4
tileheight 4

layer 0
60,60,60,60,60,60,60,60,60,60,60,60,60,60,60,60,60,60,60,60,60,60,60,60,60,60,60,60,60,0,1,60,60,60,60,60,60,60,60,60,
60,60,60,60,60,60,60,60,60,60,60,60,60,60,60,60,60,60,60,60,60,60,60,60,60,60,60,60,60,2,3,60,60,60,60,60,60,60,60,60,
60,60,60,60,60,60,60,60,60,60,60,60,60,60,60,60,60,60,60,60,60,60,60,60,60,60,60,60,60,4,5,6,60,60,60,60,60,60,60,60,
60,60,60,60,60,60,60,60,60,60,60,60,60,60,60,60,60,60,60,60,60,60,60,60,60,60,60,60,60,7,8,9,10,60,60,60,60,60,60,60,
60,60,60,60,60,60,60,60,60,60,60,60,60,60,60,60,60,60,60,60,60,60,60,60,60,60,60,60,60,11,12,13,14,15,60,60,60,60,60,60,
60,60,60,60,60,60,60,60,60,60,60,60,60,60,60,60,60,60,60,60,60,60,60,60,60,60,60,60,16,17,18,19,20,21,22,60,60,60,60,60,
23,23,23,23,23,23,23,23,23,24,25,26,27,28,29,30,31,32,33,34,35,36,37,38,39,40,41,42,43,44,45,46,47,48,49,50,60,60,60,60,
51,51,51,51,51,51,51,51,51,51,51,51,51,51,51,51,51,51,51,51,51,51,51,51,51,51,51,51,52,53,54,55,56,57,58,59,60,60,60,60,
61,62,62,62,62,62,62,62,62,62,62,62,63,62,62,62,64,62,62,62,62,62,62,62,62,62,65,65,66,67,68,69,70,71,72,73,60,60,60,60,
74,75,76,76,76,76,76,76,77,78,79,80,81,82,83,84,85,86,87,88,89,76,76,76,76,76,90,91,92,93,94,95,96,97,98,99,100,60,60,60,
101,102,103,103,103,103,103,103,103,103,103,103,103,103,103,103,104,103,103,103,103,103,103,103,103,103,103,103,103,105,106,107,108,60,109,110,111,112,60,60,
113,103,103,103,103,103,103,103,103,103,103,103,103,103,103,103,103,103,114,115,116,117,117,117,118,119,117,117,117,120,121,122,123,124,125,126,127,128,60,60,
129,103,103,103,103,103,103,103,103,103,103,103,103,103,103,103,130,131,132,103,103,103,103,103,103,103,103,103,103,103,133,134,135,136,137,138,139,140,60,60,
129,103,103,103,103,103,103,103,103,103,103,103,103,103,103,141,142,103,103,103,103,103,103,103,103,103,103,103,103,103,143,144,145,146,147,148,149,150,60,60,
129,103,103,103,103,103,103,103,103,103,103,103,103,103,141,151,152,103,153,103,103,103,103,103,103,103,103,103,103,103,105,106,154,155,156,157,158,159,60,60,
129,103,103,103,103,103,103,103,103,103,103,103,103,160,151,103,161,103,103,103,103,103,103,103,103,103,103,103,103,103,162,163,164,165,166,167,168,169,60,60,
129,103,103,103,103,103,103,103,103,103,103,103,103,170,103,171,103,103,172,173,173,173,173,173,173,173,173,173,173,174,175,176,177,178,179,180,181,182,60,60,
183,184,185,186,103,103,103,103,103,103,103,103,187,188,103,103,103,189,190,191,192,193,192,194,192,192,192,192,192,192,192,195,196,197,198,199,200,201,60,60,
202,203,204,205,206,103,103,103,103,103,103,103,129,103,103,103,207,103,103,208,209,209,210,209,209,209,209,209,209,209,209,211,106,212,213,214,215,216,60,60,
217,218,219,220,221,222,103,103,223,103,103,224,129,103,103,225,103,103,103,226,209,209,209,227,209,209,209,209,209,209,209,228,229,230,231,232,233,234,60,60,
129,114,235,236,237,238,103,103,103,103,103,103,129,103,103,239,103,103,103,240,209,209,209,241,209,209,209,209,209,209,209,209,242,62,243,244,245,246,247,60,
248,249,250,251,252,103,103,103,103,103,103,103,129,103,103,253,254,103,103,255,209,209,256,257,209,209,209,209,209,209,209,209,258,62,259,260,261,262,263,60,
264,265,266,267,268,103,103,103,103,103,103,103,269,270,103,103,271,272,103,273,209,274,275,209,209,209,209,209,209,209,209,209,276,277,278,279,280,281,282,60,
283,284,285,286,103,103,103,103,103,103,103,103,103,287,103,103,103,288,289,290,291,292,293,293,293,293,294,293,293,293,293,293,295,296,297,298,299,300,60,60,
129,103,103,103,103,103,103,103,103,103,103,103,103,253,103,103,103,103,103,301,302,303,304,305,306,305,306,304,304,304,304,304,304,307,62,308,309,310,311,60,
129,103,103,103,103,103,103,103,103,103,103,103,103,103,312,103,103,103,103,103,103,103,103,103,103,103,103,103,103,103,103,103,103,313,62,314,315,316,60,60,
129,103,103,103,103,103,103,103,103,103,103,103,103,103,317,318,103,103,103,103,103,103,103,103,103,103,103,103,103,103,103,103,103,319,320,62,321,322,60,60,
129,103,103,103,103,103,103,103,103,103,103,103,103,103,103,323,103,103,103,103,103,103,103,103,103,103,103,103,103,103,103,103,103,324,325,62,326,327,60,60,
129,103,103,103,103,103,103,103,103,103,103,103,103,103,103,103,328,103,103,103,103,103,103,103,103,103,103,103,103,103,103,103,103,103,329,62,330,331,60,60,
129,103,103,103,103,103,103,103,103,103,103,103,103,103,103,103,332,333,103,103,103,103,103,103,103,103,103,103,103,103,103,103,103,103,334,62,335,336,337,60,
129,103,103,103,103,103,103,103,103,103,103,103,103,103,103,103,103,269,338,103,103,103,103,103,103,103,103,103,103,103,103,103,103,103,319,320,62,339,340,341,
129,103,103,103,103,103,103,103,103,103,103,103,103,103,103,103,103,103,103,342,272,103,103,103,103,103,103,103,103,103,103,103,103,103,324,325,62,343,344,345,
129,103,103,103,103,103,103,103,103,103,103,103,103,103,103,103,103,103,103,103,346,347,318,103,103,103,103,103,103,103,103,103,103,103,103,329,62,348,349,350,
129,103,103,103,103,103,103,103,103,103,103,103,103,103,103,103,103,103,103,103,103,103,351,352,353,354,354,354,354,354,354,354,354,354,355,356,62,357,358,359,
129,103,103,103,103,103,103,103,103,103,103,103,103,103,103,103,103,103,103,103,103,103,103,103,103,103,103,103,103,103,103,103,103,103,103,319,320,62,360,361,
129,362,103,103,103,103,103,103,103,103,103,103,103,103,103,103,103,103,103,103,103,103,103,103,103,103,103,103,103,103,103,103,103,103,103,324,363,62,364,365,
366,367,354,354,354,354,354,354,354,354,354,354,354,354,354,354,354,354,354,354,354,354,354,354,354,354,354,354,354,354,354,354,354,354,354,354,368,62,62,62,
369,370,371,371,371,371,371,371,371,371,371,371,371,371,371,371,371,371,371,371,371,371,371,371,371,371,371,371,371,371,371,371,371,371,371,372,373,62,62,62,
61,62,62,62,62,62,62,62,62,62,62,62,62,62,62,62,62,62,62,62,62,62,62,62,62,62,62,62,62,62,62,62,62,62,62,62,62,62,62,62,

